00000000110000001100000000
00000000110000001100000000
00333333110000000000000000
00333333110000000002222222
11333333000000000000000000
11333333000000000000000000
33333333000000110011111110
33333333000000110011111100
33333333111111110011000100
33333333111111000011000100
33333333000011000000000100
33333333000011000000000100
00330000000022222200003300
00330000000022222200003300
00000000000000000033333333
00110011000000000033333333
11100111100111111133333333
11100111100100000033333333
00000000001100000033333333
00000000001100111133333333
11000020000000111133333300
11000020000000000033333300
11110020000000000033333300
11110020000111100033333300
22111100000100100011000000
22111100000100100011000000