00333300000000000000003300
00333300000000000000003300
33330000001111000000000033
33330000111111111100000033
33000001111111111111000022
33000001111111111111110000
22000011111111111111111000
00000011111111111111111000
00000111000000111111001000
00000100000000001111001000
55000100200020001110000000
55000100200020001110000000
00001100000000001110005555
00001100111100001110005555
00001111111111111111000000
00001111111111111111000000
00011111111111111111100000
00011111111111111111100000
00111111111111111111110000
00000011111111111100000000
00111100111111110011110033
00111111001111001111110033
33001111000000001111003333
33000000000111100000003333
22330000000100100000333322
22330000000100100000333322