00000000111100000000000000
00000000111100000000000000
00000000110000002222220000
22001100110000000000220000
22001100000011000000000000
22001100000011000000000000
11001111110011110055550055
11001111110011110055550055
11000000110000000055000000
00000000000000000055000000
00000000555500555555001111
00001100555500555555001111
11110000551100111000000000
11110000551100111000000000
00000000550000000000022000
00000000550000000000022000
55555500550022001100020000
55555500550022001100020000
00000000000000000000021111
00000011110000000000021111
00000000111111111100000000
00000000110000001111000000
11111100000000000011110000
11110000000111100000110000
11000000000100100000000000
00000000000100100000000000